andjela.jost@sem.admin.ch 	Kohorte I - POPM
brigitte.graf@sem.admin.ch 	Kohorte I - POPM
denise.baltensperger@sem.admin.ch	Kohorte I - POPM
dirk.seiler@sem.admin.ch	Kohorte I - POPM
fatima.granget@sem.admin.ch	Kohorte I - POPM
felix.luepold@sem.admin.ch 	Kohorte I - POPM
funda.genc@sem.admin.ch 	Kohorte I - POPM
gabriele.benjaminradehrhardt@sem.admin.ch 	Kohorte I - POPM
jannis.bont@sem.admin.ch 	Kohorte I - POPM
markus.haudenschild@sem.admin.ch	Kohorte I - POPM
martin.kaesermann@sem.admin.ch	Kohorte I - POPM
mischa.elmiger@sem.admin.ch 	Kohorte I - POPM
nicole.arzrouni@sem.admin.ch 	Kohorte I - POPM
patrick.zberg@sem.admin.ch 	Kohorte I - POPM
roland.zimmermann@sem.admin.ch 	Kohorte I - POPM
samuel.meinen@sem.admin.ch 	Kohorte I - POPM
sandra.binggeli@sem.admin.ch 	Kohorte I - POPM
viorel.dupu@sem.admin.ch 	Kohorte I - POPM
fabio.sinisi@sem.admin.ch	Kohorte I - POPM
andreas.styrnol@sem.admin.ch 	Kohorte II - POPM
andreas.waelchli@sem.admin.ch 	Kohorte II - POPM
annarita.rombini@sem.admin.ch	Kohorte II - POPM
christina.schmid@sem.admin.ch 	Kohorte II - POPM
doruntina.raci@sem.admin.ch 	Kohorte II - POPM
gabriele.benjaminradehrhardt@sem.admin.ch	Kohorte II - POPM
gil.gaillard@sem.admin.ch 	Kohorte II - POPM
kristina.brhelova@sem.admin.ch 	Kohorte II - POPM
lia.schmutz@sem.admin.ch 	Kohorte II - POPM
marlene.gyger@sem.admin.ch 	Kohorte II - POPM
michel.baetscher@sem.admin.ch 	Kohorte II - POPM
nadine.friedel@sem.admin.ch	Kohorte II - POPM
nicolas.thalmann@sem.admin.ch 	Kohorte II - POPM
patrick.tercier@sem.admin.ch 	Kohorte II - POPM
sandro.gerber@sem.admin.ch 	Kohorte II - POPM
sebastian.fischer@sem.admin.ch 	Kohorte II - POPM
simon.ruch@sem.admin.ch 	Kohorte II - POPM
therese.dauwalder@sem.admin.ch 	Kohorte II - POPM
kristina.brhelova@sem.admin.ch 	Kohorte III - LS
david.tchalabian@sem.admin.ch	Kohorte III - LS
markus.meister@sem.admin.ch	Kohorte III - LS
maryse.bonguardo@sem.admin.ch	Kohorte III - LS
max.suter@sem.admin.ch	Kohorte III - LS
lukas.herren@sem.admin.ch	Kohorte III - LS
evelyn.nydegger@sem.admin.ch	Kohorte III - LS
bjoern.wiechmann@sem.admin.ch	Kohorte IV - LS
andres.meier@sem.admin.ch	Kohorte IV - LS
daniela.schmutz@sem.admin.ch	Kohorte IV - LS
dina.byland@sem.admin.ch	Kohorte IV - LS
june.howald@sem.admin.ch	Kohorte IV - LS
martin.kaesermann@sem.admin.ch	Kohorte IV - LS
matthias.wild@sem.admin.ch	Kohorte IV - LS
pascal.buechner@sem.admin.ch	Kohorte IV - LS
patrick.lachat@sem.admin.ch	Kohorte IV - LS
tanja.kuery@sem.admin.ch	Kohorte IV - LS
alexi.calonder@sem.admin.ch	Kohorte IV - LS
annick.doriot@sem.admin.ch	Kohorte V - POPM
christian.baumann@sem.admin.ch	Kohorte V - POPM
joel.zurflueh@sem.admin.ch	Kohorte V - POPM
michael.tomsett@sem.admin.ch	Kohorte V - POPM
petra.moser-noger@sem.admin.ch	Kohorte V - POPM
karinesophie.peltier@sem.admin.ch	Kohorte V - POPM
yvonne.bosshard@sem.admin.ch	Kohorte V - POPM
patrick.kaeppeli@sem.admin.ch	Kohorte V - POPM
